NO ./cub3d-tester/textures/wood.xpm
SO ./cub3d-tester/textures/wood.xpm
EA ./cub3d-tester/textures/wood.xpm
WE ./cub3d-tester/textures/wood.xpm
F 122,122,122
C 122,122,122


       1111111111
       1000000001
       1000000001
11111111000000001
10000000000000001
10000000000000001
10000000N00000001
10000000000000001
10000000000000001
10000000000000001
10000000000000001
10000000000000001
11111111111111111