NO texture/wall1.xpm
SO texture/wall2.xpm
EA texture/wall3.xpm
WE texture/wall4.xpm
F 255,200,160
C 0,122,122

111111111111111111111111111111111111111111111111
111111111111111111111111111111111111111101111111
100000000000000000000000000000000000000000000001
100000000000000000000000000000000000000000000001
111111111111101111111111111111111111111111111111
100000000000000000000000100000000000000001000001
100000000000000000000000000000000000000001000001
100000E00000000010000000000000000000000001000001
100000000000000000000000100100000000000001000001
111001100011111000111000110011000111110011001101
111001111001100011111000110001100011111001100111
100111110001100110001111110011000111110011001101
111001100011111000110011000111110001100110001101
111001100011111000110011000111110011110011001101
111001100011111000110010110011000111110011001101
111001100011100011111000110011000111110011001101
111001100011111000110011000111110011110011001101
111001100011111000110010110011000111110011001101
111001100011111000110011000011000111110011001101
111001100011111000110011000111000111110011001101
111001100011111000110011010011000111110011001101
111001100011111000110011000011000111110011001101
111111111111111111111111111111111111111111111111