NO /home/paula/42lisboa/cub_teste/images/wall.xpm
SO /home/paula/42lisboa/cub_teste/images/wall.xpm
EA /home/paula/42lisboa/cub_teste/images/wall.xpm
WE /home/paula/42lisboa/cub_teste/images/wall.xpm
C 255,200,160
F 122,122,122

111111
100N01
111111