NO /home/paula/42lisboa/cub_teste/images/wall.xpm
SO /home/paula/42lisboa/cub_teste/images/wall.xpm
EA /home/paula/42lisboa/cub_teste/images/wall.xpm
WE /home/paula/42lisboa/cub_teste/images/wall.xpm
F 255,200,160
C 0,122,122

111111111111111111111111111111111111111111111111111111111111111111111
111111111111111111111111111111111111111101111110111111111111011111111
100000000000000000000000000000000000000000000000000000000000000000001
100000000000000000000000000000000000000000000000000000000000000000001
111111111111101111111111111111111111111111111110111111111111111111111
100000000000000000000000100100000000000000000000000010000000000000001
100000000000000000000000100000000000000000000000000010000000000000001
10000000000000000E000000000100000000000000000000000010000000000000001
100000000000000000000000100100000000000000000000000010000000000000001
111001100011111000110011000111110001100110001111100110011000111110001
111001100011111000110011000111110001100110001111100110011000111110001
111001100011111000110011000111110001100110001111100110011000111110001
111001100011111000110011000111110001100110001111100110011000111110001
111001100011111000110011000111110001100110001111100110011000111110001
111001100011111000110011000111110001100110001111100110011000111110001
111001100011111000110011000111110001100110001111100110011000111110001
111001100011111000110011000111110001100110001111100110011000111110001
111001100011111000110011000111110001100110001111100110011000111110001
111001100011111000110011000111110001100110001111100110011000111110001
111001100011111000110011000111110001100110001111100110011000111110001
111001100011111000110011000111110001100110001111100110011000111110001
111001100011111000110011000111110001100110001111100110011000111110001
111111111111111111111111111111111111111111111111111111111111111111111