NO /home/paula/42lisboa/cub_teste/images/wall.xpm
SO /home/paula/42lisboa/cub_teste/images/wall.xpm
EA /home/paula/42lisboa/cub_teste/images/wall.xpm
WE /home/paula/42lisboa/cub_teste/images/wall.xpm
C 255,200,160
F 122,122,122

111111111111111111111111111111111111111111111111111111111111111111111
111111111111111111111111111111111111111101111110111111111111011111111
100000000000000000000000000000000000000000000000000000000000000000001
100000000000000000000000000000000000000000000000000000000000000000001
111111111111101111111111111111111111111111111110111111111111111111111
100000000000000000000000100100000000000000000000000010000000000000001
100000000000000000000000100100000000000000000000000010000000000000001
100000000000000000000000100100000000000000000000000010000000000000001
100000000000000000000000100100000000000000000000000010000000000000001
111001100011111000110011000111110001100110001111100110011000111110001
111001100011111000110011000111110001100110001111100110011000111110001
111001100011111000110011000111110001100110001111100110011000111110001
111001100011111000110011000111110001100110001111100110011000111110001
111001100011111000110011000111110001100110001111100110011000111110001
111001100011111000110011000111110001100110001111100110011000111110001
111001100011111000110011000111110001100110001111100110011000111110001
111001100011111000110011000111110001100110001111100110011000111110001
111001100011111000110011000111110001100110001111100110011000111110001
111001100011111000110011000111110001100110001111100110011000111110001
111001100011111000110011000111110001100110001111100110011000111110001
111001100011111000110011000111110001100110001111100110011000111110001
111001100011111000110011000111110001100110001111100110011000111110001
111001100011111000110011000111110001100110001111100110011000111110001
111001100000001111110011000000011001100110000000110110011000000011001
111001100000001100110011000000011001100110000000110110011000000011001
111111100001111000111111000011110001111110000111100111111000011110001
101111100011000000011111000110000000111110001100000011111000110000001
100001100011000000000011000110000000000110001100000000011000110000001
100001100011111100000011000111111111110110001111110000011000111111001
101110111010111010111110101010111111011101011101011111010101011111101
100010001010100010001000101010001001000101010001000100010101000100001
111111101010101111101011101011101111110101010111110101110101110111001
100000000000000000000000000000000000000000000000000000000000000000001
100000000000000000000000000000000000000000000000000000000000000000001
1000000000000000000000000000000000N0000000000000000000000000000000001
100000000000000000000000000000000000000000000000000000000000000000001
111111111111111111111111111111111111111111111111111111111111111111111