11111111111111111
1000000  S0000001
10000000000000001
11111111111111111
