NO                     MEUCAMINHODONORTE
SO issoehumsulnazi              WE weehoeste
EA lestesechamaleste F floorinthedancing C jhj


    1
1111011111111111111
10000000S000000001111   
1000000000001000111
11111111111111111                   
                                 1
                                  1
                                 101
                                  1