NO                     MEUCAMINHODONORTE
SO issoehumsulnazi              WE weehoeste
EA lestesechamaleste F floorinthedancing C jhj


    1
1111011111111111111
100000000000000001111
10000000000010001  
11111111111111111                   
                                 1