NO                     MEUCAMINHODONORTE
SO issoehumsulnazi              WE weehoeste
EA lestesechamaleste F floorinthedancing C jhj


    1
1111011111111111111
1000000000000001
10000000000000001 0
11111111111111111                   
                                 1