NO                     MEUCAMINHODONORTE
SO issoehumsulnazi              WE weehoeste
EA lestesechamaleste F floorinthedancing C jhj


    1
1111011111111111111
100000000000000CCCC1111
10000000000000001  
11111111111111111                   
                                 1