11111111111111111
10000000P00000001
1EC00000000000001
11111111111111111
